

        NO ./img/biere.xpm
        SO ./img/salad.xpm





         WE ./img/red-bulls.xpm
EA ./img/chips.xpm

F 186,172,124
C 18,60,158


1 1
111111111111111111111111
11000000000000000000000111
1111011111000000000011111
10000000000000000000001
101110000000000000000001111
100000000011111110000111
10000000000000000000001
1000011111110000000000011111
10000000000000011111111
10000000000W000000000011111
100000111111100000000001
1000000000000000000000011111  
11111111111111111111111
11