111111
110001
110001
1N0001
111111